00000000
02222220
02444420
02222220
00000000