00000000
00011000
00122100
00011000
00000000