10000001
02200220
00033000
04400440
50000005